{
  "0": {
    "board": [
      [0,0,0,1,1],
      [0,1,0,0,0],
      [0,0,0,0,0],
      [0,0,1,0,8],
      [0,0,1,0,1]
    ],
    "start": {"x": 4, "y": 3},
    "width": 5,
    "height": 5
  },
  
  "1": {
    "board": [
      [0,0,0,0,0,0,0,0],
      [0,0,0,0,0,8,1,0],
      [0,0,0,0,0,1,1,0],
      [0,0,1,0,0,1,1,1],
      [0,0,1,0,0,0,0,0],
      [0,0,0,0,0,0,0,0]
    ],
    "start": {"x":5, "y":1},
    "width": 8,
    "height": 6
  },

  "2": {
    "board": [
      [0,0,0,0,1,1,0,0,0,1],
      [0,0,0,0,0,0,1,1,0,0],
      [0,1,0,0,0,0,8,1,1,0],
      [0,0,0,0,0,1,1,0,0,0],
      [0,0,1,0,0,1,1,0,0,0],
      [0,0,0,0,0,0,0,0,0,0]
    ],
    "start": {"x": 6, "y": 2},
    "width": 10,
    "height": 6
  },

  "3": {
    "board": [
      [0,0,1,0,0,0,0,0,0,0,0,0],
      [0,0,1,1,0,0,0,1,0,0,1,0],
      [0,0,0,0,0,0,0,1,0,0,0,0],
      [0,0,0,0,0,0,0,1,0,0,0,0],
      [0,0,0,0,0,0,0,1,0,0,1,0],
      [1,0,0,0,0,1,1,8,0,0,1,0],
      [1,0,0,1,0,0,0,0,1,0,0,0],
      [1,1,0,0,0,0,0,0,0,0,0,0]
    ],
    "start": {"x":7, "y":5},
    "width": 12,
    "height": 8
  },

  "4" : {
    "board": [
      [0,0,0,0,1,1,0,0,0,0,0,0],
      [1,0,0,0,1,0,0,0,0,0,0,0],
      [0,0,1,1,0,0,1,1,1,1,1,0],
      [0,0,0,0,0,0,0,0,0,1,0,0],
      [0,0,0,0,0,0,0,0,0,1,0,1],
      [0,0,0,1,0,0,0,0,0,1,0,1],
      [0,1,0,0,0,0,0,0,0,1,0,0],
      [0,1,0,0,0,1,1,0,0,0,0,0],
      [0,1,0,0,0,1,0,0,1,0,0,0],
      [0,0,0,0,0,1,0,0,8,0,0,0]
    ],
    "start": {"x":8, "y":9},
    "width": 12,
    "height": 10
  },

  "5" : {
  "board": [
    [1,0,1,0,0,0,0,0,1,0,0,0],
    [1,0,1,0,0,1,1,0,0,0,0,0],
    [0,0,0,0,0,0,1,0,0,0,0,0],
    [0,1,0,0,0,0,0,0,0,0,1,0],
    [0,0,0,0,0,1,8,0,0,0,0,0],
    [1,0,0,0,0,0,1,0,1,0,0,0],
    [0,0,0,0,0,0,0,0,1,1,0,0],
    [0,1,1,1,0,1,0,0,1,0,0,1],
    [0,0,0,0,0,0,1,0,0,0,0,0],
    [0,0,1,0,0,0,1,1,0,0,0,0]
  ], "start": {"x":6, "y":4},
  "width": 12,
  "height": 10
  }
}