{
    "beginner": {
        "0": {
            "board": [
                [0,0,0,1,1],
                [0,1,0,0,0],
                [0,0,0,0,0],
                [0,0,1,0,8],
                [0,0,1,9,1]
            ],
            "start": {"x": 4, "y": 3},
            "end": {"x": 3, "y": 4},
            "width": 5,
            "height": 5
          }
    },
    "easy": {
        "0": {
            "board": [
                [0,0,0,0,0,0,0,0],
                [0,0,0,0,0,8,1,0],
                [0,0,0,0,0,1,1,9],
                [0,0,1,0,0,1,1,1],
                [0,0,1,0,0,0,0,0],
                [0,0,0,0,0,0,0,0]
            ],
            "start": {"x":5, "y":1},
            "end": {"x":7, "y":2},
            "width": 8,
            "height": 6
        }
    },
    "normal": {
        "0": {
            "board": [
              [0,0,0,0,1,1,9,0,0,1],
              [0,0,0,0,0,0,1,1,0,0],
              [0,1,0,0,0,0,8,1,1,0],
              [0,0,0,0,0,1,1,0,0,0],
              [0,0,1,0,0,1,1,0,0,0],
              [0,0,0,0,0,0,0,0,0,0]
            ],
            "start": {"x": 6, "y": 2},
            "end": {"x": 6, "y": 0},
            "width": 10,
            "height": 6
          }
    },
    "hard": {
        "0": {
            "board": [
              [0,0,1,9,0,0,0,0,0,0,0,0],
              [0,0,1,1,0,0,0,1,0,0,1,0],
              [0,0,0,0,0,0,0,1,0,0,0,0],
              [0,0,0,0,0,0,0,1,0,0,0,0],
              [0,0,0,0,0,0,0,1,0,0,1,0],
              [1,0,0,0,0,1,1,8,0,0,1,0],
              [1,0,0,1,0,0,0,0,1,0,0,0],
              [1,1,0,0,0,0,0,0,0,0,0,0]
            ],
            "start": {"x":7, "y":5},
            "end": {"x":3, "y":0},
            "width": 12,
            "height": 8
          }
    },
    "expert": {
        "0" : {
            "board": [
              [9,0,0,0,1,1,0,0,0,0,0,0],
              [1,0,0,0,1,0,0,0,0,0,0,0],
              [0,0,1,1,0,0,1,1,1,1,1,0],
              [0,0,0,0,0,0,0,0,0,1,0,0],
              [0,0,0,0,0,0,0,0,0,1,0,1],
              [0,0,0,1,0,0,0,0,0,1,0,1],
              [0,1,0,0,0,0,0,0,0,1,0,0],
              [0,1,0,0,0,1,1,0,0,0,0,0],
              [0,1,0,0,0,1,0,0,1,0,0,0],
              [0,0,0,0,0,1,0,0,8,0,0,0]
            ],
            "start": {"x":8, "y":9},
            "end": {"x":0, "y":0},
            "width": 12,
            "height": 10
          },
          
          "1" : {
            "board": [
              [1,9,1,0,0,0,0,0,1,0,0,0],
              [1,0,1,0,0,1,1,0,0,0,0,0],
              [0,0,0,0,0,0,1,0,0,0,0,0],
              [0,1,0,0,0,0,0,0,0,0,1,0],
              [0,0,0,0,0,1,8,0,0,0,0,0],
              [1,0,0,0,0,0,1,0,1,0,0,0],
              [0,0,0,0,0,0,0,0,1,1,0,0],
              [0,1,1,1,0,1,0,0,1,0,0,1],
              [0,0,0,0,0,0,1,0,0,0,0,0],
              [0,0,1,0,0,0,1,1,0,0,0,0]
            ], "start": {"x":6, "y":4},
            "end": {"x":1, "y":0},
            "width": 12,
            "height": 10
          }
    }
}